...############################
............#...........#.....#
####..####..#..#..####..####..#
#..#.....#.....#.....#..#.....#
#..#..####..#..#######..####..#
#.....#.....#..#..#...........#
#######..#..####..#..#..####..#
#........#.....#.....#.....#..#
####..#######..#..#..#..#######
#...........#..#..#..#..#..#..#
#######..####..####..#..#..#..#
#........#.....#.....#..#.....#
#..####..#..################..#
#..#.....#..#...........#.....#
#######..##########..#..#..#..#
#...........#........#.....#..#
#######..#..#..#######..#..#..#
#........#..#.....#..#..#..#..#
#######..#..#..####..#..#..####
#........#........#.....#......
############################...